S’inspirant	VER:ppre	S’inspirant
du	PRP:det	du
roman	NOM	roman
autobiographique	ADJ	autobiographique
de	PRP	de
Nick	NAM	Nick
Flynn	NAM	Flynn
Paul	NAM	Paul
Weitz	NAM	Weitz
décrit	VER:pres	décrire
les	DET:ART	le
retrouvailles	NOM	retrouvaille
entre	PRP	entre
un	DET:ART	un
père	NOM	père
indigne	VER:pres	indigner
et	KON	et
son	DET:POS	son
fils	NOM	fil|fils
fragile	ADJ	fragile
dans	PRP	dans
un	DET:ART	un
contexte	NOM	contexte
difficile	ADJ	difficile
clochardisation	NOM	clochardisation
suicide	VER:pres	suicider
drogue	NOM	drogue
Alors	NAM	Alors
qu’il	NOM	qu’il
aurait	VER:cond	avoir
gagné	VER:pper	gagner
à	PRP	à
se	PRO:PER	se
concentrer	VER:infi	concentrer
sur	PRP	sur
le	DET:ART	le
parcours	NOM	parcours
du	PRP:det	du
fils	NOM	fil|fils
qui	PRO:REL	qui
doit	VER:pres	devoir
accepter	VER:infi	accepter
ses	DET:POS	son
origines	NOM	origine
pour	PRP	pour
se	PRO:PER	se
réaliser	VER:infi	réaliser
comme	ADV	comme
écrivain	NOM	écrivain
le	DET:ART	le
film	NOM	film
favorise	VER:pres	favoriser
la	DET:ART	le
confusion	NOM	confusion
en	PRP	en
donnant	VER:ppre	donner
autant	ADV	autant
d’importance	NOM	d’importance
aux	PRP:det	au
deux	NUM	deux
personnages	NOM	personnage
Malgré	NAM	Malgré
des	PRP:det	du
clins	NOM	clin
d’oeil	NOM	d’oeil
appuyés	VER:pper	appuyer
à	PRP	à
Taxi	NAM	Taxi
Driver	NAM	Driver
De	NAM	De
Niro	NAM	Niro
joue	VER:pres	jouer
là	ADV	là
un	NUM	un
de	PRP	de
ses	DET:POS	son
meilleurs	ADJ	meilleur
rôles	NOM	rôle
depuis	PRP	depuis
longtemps	ADV	longtemps
Mais	VER:impf	Mais
il	PRO:PER	il
est	VER:pres	être
presque	ADV	presque
éclipsé	VER:pper	éclipser
par	PRP	par
Paul	NAM	Paul
Dano	NAM	Dano
le	DET:ART	le
roi	NOM	roi
du	PRP:det	du
minimalisme	NOM	minimalisme
,	PUN	,
N	VER:pper	N
