Au	PRP:det	au
bout	NOM	bout
d’une	NOM	d’une
longue	ADJ	longue
mise	VER:pper	mettre
en	PRP	en
place	NOM	place
particulièrement	ADV	particulièrement
sclérosée	VER:pper	scléroser
une	DET:ART	un
angoisse	NOM	angoisse
point	ADV	point
que	KON	que
la	DET:ART	le
précieuse	NOM	précieuse
singularité	NOM	singularité
de	PRP	de
la	DET:ART	le
firme	NOM	firme
à	PRP	à
la	DET:ART	le
lampe	NOM	lampe
soit	VER:subp	être
définitivement	ADV	définitivement
étouffée	VER:pper	étouffer
par	PRP	par
le	DET:ART	le
grand	ADJ	grand
frère	NOM	frère
Disney	NAM	Disney
Et	NAM	Et
puis	ADV	puis
ouf	INT	ouf
de	PRP	de
soulagement	NOM	soulagement
le	DET:ART	le
film	NOM	film
honore	VER:pres	honorer
in	ADJ	in
extremis	ADV	extremis
la	DET:ART	le
promesse	NOM	promesse
de	PRP	de
son	DET:POS	son
titre	NOM	titre
L’intrigue	NAM	L’intrigue
sort	VER:pres	sortir
enfin	ADV	enfin
des	PRP:det	du
sentiers	NOM	sentier
battus	VER:pper	battre
et	KON	et
la	DET:ART	le
fable	NOM	fable
initiatique	ADJ	initiatique
bascule	VER:pres	basculer
du	PRP:det	du
bon	ADJ	bon
côté	NOM	côté
du	PRP:det	du
manche	NOM	manche
tuer	VER:infi	tuer
ses	DET:POS	son
parents	NOM	parent|parents
avec	PRP	avec
douceur	NOM	douceur
symboliquement	ADV	symboliquement
s’entend	VER:pres	s’entend
morale	NOM	morale
progressiste	ADJ	progressiste
pas	ADV	pas
si	ADV	si
fréquente	ADJ	fréquent
dans	PRP	dans
le	DET:ART	le
petit	ADJ	petit
monde	NOM	monde
du	PRP:det	du
cinéma	NOM	cinéma
pour	PRP	pour
enfants	NOM	enfant
,	PUN	,
N	VER:pper	N
