Une	DET:ART	un
fois	NOM	foi|fois
encore	ADV	encore
Pixar	NAM	Pixar
parvient	VER:pres	parvenir
à	PRP	à
étonner	VER:infi	étonner
pla	NOM	pla
ant	VER:subi	ant
son	DET:POS	son
Rebelle	NOM	rebelle
à	PRP	à
l’esthétique	NOM	l’esthétique
éblouissante	ADJ	éblouissant
au	PRP:det	au
ton	NOM	ton
subtil	ADJ	subtil
et	KON	et
mature	VER:pres	maturer
loin	ADV	loin
des	PRP:det	du
sentiers	NOM	sentier
battus	VER:pper	battre
,	PUN	,
P	NAM	P
