Autour	ADV	autour
des	PRP:det	du
rapports	NOM	rapport
homme	NOM	homme
femme	NOM	femme
cette	PRO:DEM	ce
comédie	NOM	comédie
estivale	ADJ	estival
un	DET:ART	un
brin	NOM	brin
longuette	ADJ	longuet
et	KON	et
trop	ADV	trop
sage	ADJ	sage
doit	VER:pres	devoir
beaucoup	ADV	beaucoup
à	PRP	à
l'abattage	NOM	l'abattage
de	PRP	de
son	DET:POS	son
charmant	ADJ	charmant
duo	NOM	duo
,	PUN	,
N	VER:pper	N
