Une	DET:ART	un
nouvelle	ADJ	nouveau
réflexion	NOM	réflexion
du	PRP:det	du
clan	NOM	clan
Apataow	NAM	Apataow
sur	PRP	sur
les	DET:ART	le
vicissitudes	NOM	vicissitude
du	PRP:det	du
couple	NOM	couple
avec	PRP	avec
comme	ADV	comme
toujours	ADV	toujours
une	DET:ART	un
belle	ADJ	beau
misogynie	NOM	misogynie
assumée	VER:pper	assumer
et	KON	et
acceptée	VER:pper	accepter
par	PRP	par
la	DET:ART	le
spectatrice	NOM	spectateur
C’est	NAM	C’est
certainement	ADV	certainement
là	ADV	là
que	KON	que
se	PRO:PER	se
situe	VER:pres	situer
en	PRP	en
fait	NOM	fait
la	DET:ART	le
réussite	NOM	réussite
du	PRP:det	du
film	NOM	film
,	PUN	,
P	NAM	P
