Après	PRP	après
American	NAM	American
Trip	NAM	Trip
on	PRO:PER	on
pouvait	VER:impf	pouvoir
craindre	VER:infi	craindre
que	KON	que
Nicholas	NAM	Nicholas
Stoller	NAM	Stoller
cinéaste	NOM	cinéaste
prometteur	ADJ	prometteur
de	PRP	de
Sans	NAM	Sans
Sarah	NAM	Sarah
rien	ADV	rien
ne	ADV	ne
va	VER:pres	aller
ne	ADV	ne
soit	KON	soit
condamné	VER:pper	condamner
à	PRP	à
tourner	VER:infi	tourner
un	DET:ART	un
peu	ADV	peu
en	PRP	en
rond	ADJ	rond
Mais	NAM	Mais
ce	PRO:DEM	ce
5	NUM	@card@
Ans	NOM	an
de	PRP	de
réflexion	NOM	réflexion
relance	VER:pres	relancer
la	DET:ART	le
machine	NOM	machine
avec	PRP	avec
éclat	NOM	éclat
Outre	ADV	outre
le	DET:ART	le
fabuleux	ADJ	fabuleux
Jason	NAM	Jason
Segel	NAM	Segel
sorte	NOM	sorte
de	PRP	de
Jeff	NAM	Jeff
Daniels	NAM	Daniels
jeune	ADJ	jeune
subtil	ADJ	subtil
et	KON	et
massif	ADJ	massif
on	PRO:PER	on
retrouve	VER:pres	retrouver
intacte	ADJ	intact
cette	PRO:DEM	ce
manière	NOM	manière
de	PRP	de
fixer	VER:infi	fixer
la	DET:ART	le
comédie	NOM	comédie
sur	PRP	sur
des	PRP:det	du
enjeux	NOM	enjeu
essentiellement	ADV	essentiellement
domestiques	ADJ	domestique
dans	PRP	dans
un	DET:ART	un
va	VER:pres	aller
et	KON	et
vient	VER:pres	venir
entre	PRP	entre
le	PRO:PER	le
on	PRO:PER	on
de	PRP	de
vie	NOM	vie
et	KON	et
pure	ADJ	pur
trivialité	NOM	trivialité
Le	DET:ART	le
fi	NOM	fi
lm	VER:futu	lm
fait	VER:pper	faire
donc	ADV	donc
son	DET:POS	son
miel	NOM	miel
de	PRP	de
cette	PRO:DEM	ce
addition	NOM	addition
de	PRP	de
compromis	NOM	compromis
qui	PRO:REL	qui
lézarde	VER:pres	lézarder
petit	ADJ	petit
à	PRP	à
petit	ADV	petit
la	DET:ART	le
toute	PRO:IND	tout
puissance	NOM	puissance
des	PRP:det	du
sentiments	NOM	sentiment
apprivoiser	VER:infi	apprivoiser
le	DET:ART	le
climat	NOM	climat
polaire	ADJ	polaire
ses	DET:POS	son
nouveaux	ADJ	nouveau
collègues	NOM	collègue
frustes	ADJ	fruste
la	DET:ART	le
nouvelle	ADJ	nouveau
fiche	NOM	fiche
de	PRP	de
paie	NOM	paie
maigre	ADJ	maigre
refréner	VER:infi	refréner
ses	DET:POS	son
pulsions	NOM	pulsion
égoïstes	ADJ	égoïste
sa	DET:POS	son
jalousie	NOM	jalousie
puisque	KON	puisque
la	DET:ART	le
fiancée	NOM	fiancé
s’épanouit	VER:pres	s’épanouit
de	PRP	de
son	DET:POS	son
côté	NOM	côté
Tout	NAM	Tout
cela	PRO:DEM	cela
est	VER:pres	être
troussé	VER:pper	trousser
avec	PRP	avec
une	DET:ART	un
minutie	NOM	minutie
d’orfèvre	VER:subp	d’orfèvre
parfois	ADV	parfois
jusqu’à	NOM	jusqu’à
l’épuisement	NOM	l’épuisement
Le	DET:ART	le
film	NOM	film
est	VER:pres	être
un	DET:ART	un
poil	NOM	poil
long	ADJ	long
mais	KON	mais
tellement	ADV	tellement
généreux	ADJ	généreux
qu’il	NOM	qu’il
s’en	ADJ	s’en
remet	VER:pres	remettre
divinement	ADV	divinement
,	PUN	,
P	NAM	P
