Très	ADV	très
beau	ADJ	beau
visuellement	ADV	visuellement
mais	KON	mais
après	PRP	après
un	DET:ART	un
bon	ADJ	bon
début	NOM	début
on	PRO:PER	on
tombe	VER:pres	tomber
vite	ADV	vite
dans	PRP	dans
le	DET:ART	le
lénifiant	ADJ	lénifiant
Pixar	NOM	Pixar
serait	VER:cond	être
il	PRO:PER	il
en	PRP	en
train	NOM	train
de	PRP	de
se	PRO:PER	se
confondre	VER:infi	confondre
avec	PRP	avec
Disney	NAM	Disney
tendance	NOM	tendance
morale	ADJ	moral
bien	ADV	bien
molle	ADJ	mou
,	PUN	,
N	VER:pper	N
