On	PRO:PER	on
se	PRO:PER	se
demandera	VER:futu	demander
longtemps	ADV	longtemps
pourquoi	ADV	pourquoi
le	DET:ART	le
sélectionneur	NOM	sélectionneur
en	PRP	en
chef	NOM	chef
de	PRP	de
Cannes	NAM	Cannes
a	VER:pres	avoir
privé	VER:pper	priver
de	PRP	de
compétition	NOM	compétition
ce	PRO:DEM	ce
film	NOM	film
qui	PRO:REL	qui
de	PRP	de
la	DET:ART	le
première	NUM	premier
à	PRP	à
la	DET:ART	le
dernière	ADJ	dernier
image	NOM	image
mérite	VER:pres	mériter
une	DET:ART	un
visibilité	NOM	visibilité
et	KON	et
une	DET:ART	un
reconnaissance	NOM	reconnaissance
maximales	ADJ	maximal
Non	NAM	Non
que	PRO:REL	que
la	PRO:PER	la
section	NOM	section
Un	NAM	Un
certain	PRO:IND	certain
regard	NOM	regard
o	VER:subi	o
nous	PRO:PER	nous
l’avons	VER:pres	l’avons
découvert	NOM	découvert
ait	VER:subp	avoir
quoi	PRO:REL	quoi
que	KON	que
ce	PRO:DEM	ce
soit	VER:subp	être
de	PRP	de
déshonorant	ADJ	déshonorant
Mais	NAM	Mais
on	PRO:PER	on
imagine	VER:pres	imaginer
volontiers	ADV	volontiers
le	DET:ART	le
jury	NOM	jury
de	PRP	de
Nanni	NAM	Nanni
Moretti	NAM	Moretti
carbonisé	VER:pper	carboniser
par	PRP	par
un	DET:ART	un
palmarès	NOM	palmarès
globalement	ADV	globalement
inepte	ADJ	inepte
contradictoire	ADJ	contradictoire
et	KON	et
rétrograde	VER:pres	rétrograder
issu	ADJ	issu
para	NOM	para
t	VER:simp	t
il	PRO:PER	il
de	PRP	de
ses	DET:POS	son
infernales	ADJ	infernal
délibérations	NOM	délibération
reconquérir	VER:infi	reconquérir
sa	DET:POS	son
dignité	NOM	dignité
en	PRP	en
rendant	VER:ppre	rendre
unanimement	ADV	unanimement
les	DET:ART	le
armes	NOM	arme
devant	PRP	devant
1	NUM	@card@
l’interprétation	NOM	l’interprétation
foudroyante	ADJ	foudroyant
d’	ADJ	d’
milie	NOM	milie
Dequenne	NAM	Dequenne
dont	PRO:REL	dont
rien	NOM	rien
depuis	PRP	depuis
Rosetta	NAM	Rosetta
ne	ADV	ne
laissait	VER:impf	laisser
deviner	VER:infi	deviner
ce	PRO:DEM	ce
qu’elle	NOM	qu’elle
dégoupille	VER:pres	dégoupiller
ici	ADV	ici
2	NUM	@card@
un	DET:ART	un
scénario	NOM	scénario
qui	PRO:REL	qui
telle	PRO:DEM	tel
une	DET:ART	un
plante	NOM	plante
carnivore	ADJ	carnivore
à	PRP	à
la	DET:ART	le
séduction	NOM	séduction
trompeuse	ADJ	trompeur
laisse	VER:pres	laisser
entrevoir	VER:infi	entrevoir
le	DET:ART	le
meilleur	ADJ	meilleur
à	PRP	à
son	DET:POS	son
personnage	NOM	personnage
avant	PRP	avant
de	PRP	de
le	PRO:PER	le
vider	VER:infi	vider
goutte	NOM	goutte
à	PRP	à
goutte	NOM	goutte
de	PRP	de
son	DET:POS	son
suc	NOM	suc
vital	ADJ	vital
3	NUM	@card@
la	NOM	la
s	VER:cond	s
reté	VER:pper	reté
toujours	ADV	toujours
plus	ADV	plus
ma	DET:POS	mon
trisée	NOM	trisée
avec	PRP	avec
laquelle	PRO:REL	lequel
le	DET:ART	le
jeune	ADJ	jeune
Belge	NAM	Belge
Joachim	NAM	Joachim
Lafosse	NAM	Lafosse
continue	VER:pres	continuer
de	PRP	de
décliner	VER:infi	décliner
le	DET:ART	le
thème	NOM	thème
de	PRP	de
l’innocence	NOM	l’innocence
vénérée	VER:pper	vénérer
puis	ADV	puis
manipulée	VER:pper	manipuler
puis	ADV	puis
sacrifiée	VER:pper	sacrifier
Sans	NAM	Sans
doute	VER:pres	douter
moins	ADV	moins
audacieux	ADJ	audacieux
que	KON	que
son	DET:POS	son
précédent	ADJ	précédent
film	NOM	film
lève	NOM	lève
libre	ADJ	libre
2009	NUM	@card@
perdre	VER:infi	perdre
la	DET:ART	le
raison	NOM	raison
renonce	VER:pres	renoncer
à	PRP	à
toute	PRO:IND	tout
espèce	NOM	espèce
de	PRP	de
talentueuse	ADJ	talentueux
provocation	NOM	provocation
et	KON	et
abat	VER:pres	abattre
ses	DET:POS	son
cartes	NOM	carte
dès	PRP	dès
le	DET:ART	le
départ	NOM	départ
a	VER:pres	avoir
va	VER:pres	aller
finir	VER:infi	finir
très	ADV	très
mal	ADV	mal
Dans	VER:cond	Dans
cette	PRO:DEM	ce
chronique	NOM	chronique
impitoyable	ADJ	impitoyable
d’une	VER:subp	d’une
tragédie	NOM	tragédie
annoncée	VER:pper	annoncer
c’est	NOM	c’est
avec	PRP	avec
une	DET:ART	un
sorte	NOM	sorte
de	PRP	de
fascination	NOM	fascination
désolée	VER:pper	désoler
que	KON	que
le	DET:ART	le
réalisateur	NOM	réalisateur
démantibule	VER:pres	démantibuler
les	DET:ART	le
mécanismes	NOM	mécanisme
de	PRP	de
la	DET:ART	le
tyrannie	NOM	tyrannie
de	PRP	de
la	DET:ART	le
manipulation	NOM	manipulation
et	KON	et
de	PRP	de
la	DET:ART	le
servitude	NOM	servitude
domestiques	ADJ	domestique
Entre	NOM	Entre
constat	NOM	constat
cri	NOM	cri
de	PRP	de
haine	NOM	haine
face	NOM	face
aux	PRP:det	au
dérives	NOM	dérive
de	PRP	de
l’esprit	NOM	l’esprit
de	PRP	de
famille	NOM	famille
le	DET:ART	le
tandem	NOM	tandem
Niels	NAM	Niels
Arestrup	NAM	Arestrup
Tahar	NAM	Tahar
Rahim	NAM	Rahim
est	VER:pres	être
à	PRP	à
ce	PRO:DEM	ce
titre	NOM	titre
cauchemardesque	ADJ	cauchemardesque
et	KON	et
exercice	NOM	exercice
de	PRP	de
tension	NOM	tension
psychologique	ADJ	psychologique
chauffé	VER:pper	chauffer
à	PRP	à
blanc	ADJ	blanc
le	DET:ART	le
choc	NOM	choc
est	VER:pres	être
terrible	ADJ	terrible
,	PUN	,
P	NAM	P
