La	DET:ART	le
vie	NOM	vie
au	PRP:det	au
grand	ADJ	grand
air	NOM	air
et	KON	et
les	DET:ART	le
voisins	NOM	voisin
curieux	ADJ	curieux
rythment	VER:pres	rythmer
avec	PRP	avec
douceur	NOM	douceur
le	DET:ART	le
récit	NOM	récit
d'un	ADJ	d'un
cinéaste	NOM	cinéaste
qui	PRO:REL	qui
assume	VER:pres	assumer
la	PRO:PER	la
guimauve	NOM	guimauve
Si	NAM	Si
le	DET:ART	le
genre	NOM	genre
est	VER:pres	être
réservé	VER:pper	réserver
aux	PRP:det	au
petites	ADJ	petit
filles	NOM	fille
il	PRO:PER	il
faut	VER:pres	falloir
reconna	VER:simp	reconna
tre	VER:pper	tre
que	KON	que
Hosoda	NAM	Hosoda
le	PRO:PER	le
ma	DET:POS	mon
trise	NOM	trise
avec	PRP	avec
un	NOM	un
savoir	VER:infi	savoir
faire	VER:infi	faire
certain	PRO:IND	certain
,	PUN	,
N	VER:pper	N
