L	NUM	L
éternel	NOM	éternel
grincheux	ADJ	grincheux
du	PRP:det	du
cinéma	NOM	cinéma
fran	ADJ	fran
ais	NOM	ais
Jen	NAM	Jen
Pierre	NAM	Pierre
Bacri	NAM	Bacri
entouré	VER:pper	entourer
d'acteurs	NOM	d'acteurs
au	PRP:det	au
diapason	NOM	diapason
trouve	VER:pres	trouver
un	DET:ART	un
rôle	NOM	rôle
taillé	VER:pper	tailler
sur	PRP	sur
mesure	NOM	mesure
et	KON	et
joue	NOM	joue
avec	PRP	avec
subtilité	NOM	subtilité
un	DET:ART	un
quinqua	NOM	quinqua
névrosé	ADJ	névrosé
,	PUN	,
N	VER:pper	N
