Rarement	ADV	rarement
mis	VER:pper	mettre
en	PRP	en
scène	NOM	scène
l’infanticide	ADJ	l’infanticide
est	VER:pres	être
ici	ADV	ici
donc	ADV	donc
au	PRP:det	au
c	NOM	c
ur	VER:futu	ur
d’un	ADJ	d’un
film	NOM	film
qui	PRO:REL	qui
omet	VER:pres	omettre
quelques	PRO:IND	quelque
maillons	NOM	maillon
importants	ADJ	important
dans	PRP	dans
la	DET:ART	le
réflexion	NOM	réflexion
quand	KON	quand
il	PRO:PER	il
ne	ADV	ne
dérange	VER:pres	déranger
pas	ADV	pas
quelque	PRO:IND	quelque
peu	ADV	peu
en	PRP	en
faisant	VER:ppre	faire
passer	VER:infi	passer
la	DET:ART	le
mère	NOM	mère
pour	PRP	pour
une	DET:ART	un
victime	NOM	victime
Mais	VER:impf	Mais
il	PRO:PER	il
y	PRO:PER	y
a	VER:pres	avoir
les	DET:ART	le
acteurs	NOM	acteur
tous	PRO:IND	tout
extraordinaires	NOM	extraordinaire
,	PUN	,
P	NAM	P
