On	PRO:PER	on
a	VER:pres	avoir
beau	ADJ	beau
le	PRO:PER	le
répéter	VER:infi	répéter
à	PRP	à
chaque	PRO:IND	chaque
film	NOM	film
d'animation	NOM	d'animation
de	PRP	de
la	DET:ART	le
compagnie	NOM	compagnie
mais	KON	mais
elle	PRO:PER	elle
semble	VER:pres	sembler
repousser	VER:infi	repousser
toujours	ADV	toujours
plus	ADV	plus
les	DET:ART	le
limites	NOM	limite
du	PRP:det	du
photo	NOM	photo
réalisme	NOM	réalisme
D'une	NAM	D'une
beauté	NOM	beauté
picturale	ADJ	pictural
à	PRP	à
couper	VER:infi	couper
le	DET:ART	le
souffle	NOM	souffle
Rebelle	NAM	Rebelle
est	VER:pres	être
un	DET:ART	un
nouveau	ADJ	nouveau
joyau	NOM	joyau
technologique	ADJ	technologique
L'oeuvre	NOM	L'oeuvre
est	VER:pres	être
tellement	ADV	tellement
détaillée	VER:pper	détailler
et	KON	et
fluide	ADJ	fluide
que	KON	que
certains	ADJ	certain
plans	NOM	plan
font	VER:pres	faire
véritablement	ADV	véritablement
penser	NOM	penser
à	PRP	à
des	PRP:det	du
prises	NOM	prise
de	PRP	de
vues	NOM	vue
réelles	ADJ	réel
Dommage	NAM	Dommage
que	KON	que
la	DET:ART	le
3D	NOM	3D
exploitée	VER:pper	exploiter
comme	KON	comme
un	DET:ART	un
outil	NOM	outil
plastique	ADJ	plastique
parmi	PRP	parmi
d'autres	NOM	d'autres
ne	ADV	ne
soit	VER:subp	être
ennivrant	ADJ	ennivrant
qu'à	NOM	qu'à
de	PRP	de
rares	ADJ	rare
occasions	NOM	occasion
,	PUN	,
P	NAM	P
