S'engager	VER:infi	S'engager
dans	PRP	dans
la	DET:ART	le
vie	NOM	vie
devenir	NOM	devenir
adulte	ADJ	adulte
renoncer	VER:infi	renoncer
à	PRP	à
l'insouciance	NOM	l'insouciance
du	PRP:det	du
célibat	NOM	célibat
tous	PRO:IND	tout
les	DET:ART	le
films	NOM	film
de	PRP	de
la	DET:ART	le
bande	NOM	bande
à	PRP	à
Apatow	NAM	Apatow
tournent	VER:pres	tourner
autour	ADV	autour
de	PRP	de
ce	PRO:DEM	ce
thème	NOM	thème
Aucun	NAM	Aucun
ne	ADV	ne
l'a	VER:simp	l'a
traité	VER:pper	traiter
avec	PRP	avec
autant	ADV	autant
d'acuité	VER:pper	d'acuité
et	KON	et
d'ironie	NOM	d'ironie
,	PUN	,
P	NAM	P
