Le	DET:ART	le
fond	NOM	fond
est	VER:pres	être
un	DET:ART	un
modèle	NOM	modèle
d'écriture	ADJ	d'écriture
et	KON	et
il	PRO:PER	il
faut	VER:pres	falloir
saluer	VER:infi	saluer
une	DET:ART	un
fois	NOM	foi|fois
encore	ADV	encore
cette	PRO:DEM	ce
capacité	NOM	capacité
qu'ont	VER:futu	qu'ont
les	DET:ART	le
studios	NOM	studio
Pixar	NOM	Pixar
de	PRP	de
nous	PRO:PER	nous
offrir	VER:infi	offrir
sans	PRP	sans
cesse	NOM	cesse
des	PRP:det	du
histoires	NOM	histoire
inédites	ADJ	inédit
sans	PRP	sans
jamais	ADV	jamais
chercher	VER:infi	chercher
à	PRP	à
faire	VER:infi	faire
fructifier	VER:infi	fructifier
un	NUM	un
investissement	NOM	investissement
,	PUN	,
P	NAM	P
