Les	DET:ART	le
précipices	NOM	précipice
béances	NOM	béance
et	KON	et
douleurs	NOM	douleur
intimes	ADJ	intime
auxquels	PRO:REL	auquel
nous	PRO:PER	nous
avait	VER:impf	avoir
habitués	VER:pper	habituer
Pixar	NAM	Pixar
ont	VER:pres	avoir
été	VER:pper	être
évacués	VER:pper	évacuer
au	PRP:det	au
profit	NOM	profit
d'une	NOM	d'une
histoire	NOM	histoire
niaise	ADJ	niais
dont	PRO:REL	dont
les	DET:ART	le
enjeux	NOM	enjeu
ne	ADV	ne
dérangent	VER:pres	déranger
personne	ADV	personne
Le	DET:ART	le
film	NOM	film
annihile	VER:pres	annihiler
même	ADV	même
la	DET:ART	le
charge	NOM	charge
féministe	ADJ	féministe
qu'il	NOM	qu'il
semblait	VER:impf	sembler
un	DET:ART	un
temps	NOM	temps
vouloir	VER:infi	vouloir
développer	VER:infi	développer
pour	PRP	pour
faire	VER:infi	faire
rentrer	VER:infi	rentrer
sagement	ADV	sagement
tout	ADV	tout
le	DET:ART	le
monde	NOM	monde
dans	PRP	dans
un	DET:ART	un
girond	ADJ	girond
familial	ADJ	familial
bien	ADV	bien
propret	ADJ	propret
qui	PRO:REL	qui
rédime	VER:pres	rédimer
tout	ADV	tout
,	PUN	,
N	VER:pper	N
