Magnifiquement	ADV	magnifiquement
restitués	VER:pper	restituer
les	DET:ART	le
décors	NOM	décor
envo	ADJ	envo
tants	ADJ	tants
et	KON	et
les	DET:ART	le
personnages	NOM	personnage
de	PRP	de
l’Ecosse	NOM	l’Ecosse
médiévale	ADJ	médiéval
offrent	VER:pres	offrir
un	DET:ART	un
écrin	NOM	écrin
parfait	VER:pper	parfaire
pour	PRP	pour
ce	PRO:DEM	ce
récit	NOM	récit
initiatique	ADJ	initiatique
teinté	VER:pper	teinter
d’un	ADJ	d’un
zest	NOM	zest
de	PRP	de
féminisme	NOM	féminisme
et	KON	et
de	PRP	de
beaucoup	ADV	beaucoup
d’humour	ADJ	d’humour
Esthétiquement	NOM	Esthétiquement
impeccable	ADJ	impeccable
le	DET:ART	le
film	NOM	film
joue	VER:pres	jouer
sur	PRP	sur
les	DET:ART	le
stéréotypes	NOM	stéréotype
du	PRP:det	du
folklore	NOM	folklore
écossais	ADJ	écossais
et	KON	et
offre	VER:pres	offrir
aussi	ADV	aussi
quelques	PRO:IND	quelque
frayeurs	NOM	frayeur
Ne	NAM	Ne
manque	ADJ	manque
qu’une	NOM	qu’une
vraie	ADJ	vrai
méchante	ADJ	méchant
pour	PRP	pour
faire	VER:infi	faire
de	PRP	de
ce	PRO:DEM	ce
Disney	NAM	Disney
un	DET:ART	un
classique	NOM	classique
du	PRP:det	du
genre	NOM	genre
,	PUN	,
P	NAM	P
