Tendre	ADJ	tendre
et	KON	et
décalée	VER:pper	décaler
cette	PRO:DEM	ce
comédie	NOM	comédie
trouve	VER:pres	trouver
son	DET:POS	son
rythme	NOM	rythme
autour	ADV	autour
de	PRP	de
ses	DET:POS	son
personnages	NOM	personnage
adultes	ADJ	adulte
tous	PRO:IND	tout
un	DET:ART	un
peu	ADV	peu
perdus	ADJ	perdu
bien	ADV	bien
que	KON	que
cernés	VER:pper	cerner
d’amour	NOM	d’amour
L’humour	NAM	L’humour
et	KON	et
l’émotion	NOM	l’émotion
sont	VER:pres	être
au	PRP:det	au
rendez	VER:pres	rendre
vous	PRO:PER	vous
souvent	ADV	souvent
gentils	ADJ	gentil
parfois	ADV	parfois
appuyés	VER:pper	appuyer
mais	KON	mais
toujours	ADV	toujours
joliment	ADV	joliment
éclairés	VER:pper	éclairer
à	PRP	à
la	DET:ART	le
lumière	NOM	lumière
des	PRP:det	du
années	NOM	année
1980	NUM	@card@
et	KON	et
des	PRP:det	du
désarrois	NOM	désarroi
du	PRP:det	du
quotidien	NOM	quotidien
Une	VER:cond	Une
échappée	VER:pper	échapper
sympathique	ADJ	sympathique
forte	ADJ	fort
de	PRP	de
son	DET:POS	son
aimable	ADJ	aimable
casting	NOM	casting
rassemblé	VER:pper	rassembler
autour	ADV	autour
d’Agnès	ADJ	d’Agnès
Jaoui	NOM	Jaoui
ici	ADV	ici
mémorable	ADJ	mémorable
et	KON	et
touchante	ADJ	touchant
en	PRP	en
mère	NOM	mère
juive	ADJ	juif
,	PUN	,
P	NAM	P
