Comme	ADV	comme
souvent	ADV	souvent
dans	PRP	dans
les	DET:ART	le
films	NOM	film
de	PRP	de
Pascal	NAM	Pascal
Bonitzer	NAM	Bonitzer
les	DET:ART	le
personnages	NOM	personnage
sont	VER:pres	être
bavards	ADJ	bavard
et	KON	et
le	DET:ART	le
fond	NOM	fond
grave	ADJ	grave
n'empêche	NOM	n'empêche
pas	ADV	pas
un	DET:ART	un
ton	NOM	ton
ludique	ADJ	ludique
D'o	NAM	D'o
vient	VER:pres	venir
alors	ADV	alors
le	DET:ART	le
sentiment	NOM	sentiment
que	PRO:REL	que
cette	PRO:DEM	ce
fois	NOM	foi|fois
ci	ADV	ci
la	DET:ART	le
mécanique	NOM	mécanique
est	VER:pres	être
légèrement	ADV	légèrement
grippée	VER:pper	gripper
Peut	VER:pres	pouvoir
être	VER:infi	être
d'une	NOM	d'une
certaine	PRO:IND	certain
lassitude	NOM	lassitude
de	PRP	de
retrouver	VER:infi	retrouver
pour	PRP	pour
la	DET:ART	le
énième	ADJ	énième
fois	NOM	foi|fois
ce	PRO:DEM	ce
milieu	NOM	milieu
intellonanti	VER:pper	intellonanti
plus	ADV	plus
à	PRP	à
l'aise	NOM	l'aise
dans	PRP	dans
le	DET:ART	le
discours	NOM	discours
que	KON	que
dans	PRP	dans
l'action	NOM	l'action
,	PUN	,
N	VER:pper	N
