Bien	ADV	bien
au	PRP:det	au
delà	ADV	delà
du	PRP:det	du
fait	NOM	fait
divers	ADJ	divers
dont	PRO:REL	dont
il	PRO:PER	il
s'inspire	VER:pres	s'inspire
le	DET:ART	le
nouveau	ADJ	nouveau
film	NOM	film
de	PRP	de
Joachim	NAM	Joachim
Lafosse	NAM	Lafosse
se	PRO:PER	se
vit	VER:pres	vivre
comme	ADV	comme
une	DET:ART	un
sublime	NOM	sublime
et	KON	et
déchirante	ADJ	déchirant
tragédie	NOM	tragédie
dont	PRO:REL	dont
l'issue	VER:pres	l'issue
nous	PRO:PER	nous
est	VER:pres	être
révélée	VER:pper	révéler
avec	PRP	avec
beaucoup	ADV	beaucoup
d'intelligence	NOM	d'intelligence
dès	PRP	dès
les	DET:ART	le
premières	NUM	premier
minutes	NOM	minute
Outre	NOM	outre
la	DET:ART	le
justesse	NOM	justesse
du	PRP:det	du
regard	NOM	regard
portée	VER:pper	porter
sur	PRP	sur
cette	PRO:DEM	ce
femme	NOM	femme
en	PRP	en
perdition	NOM	perdition
on	PRO:PER	on
admire	VER:pres	admirer
l'intensité	VER:pper	l'intensité
d'Emilie	VER:pper	d'Emilie
Dequenne	NOM	Dequenne
stupéfiante	ADJ	stupéfiant
de	PRP	de
bout	NOM	bout
en	PRP	en
bout	NOM	bout
,	PUN	,
P	NAM	P
