Les	DET:ART	le
réalisateurs	NOM	réalisateur
mélangent	VER:pres	mélanger
laborieusement	ADV	laborieusement
les	DET:ART	le
codes	NOM	code
guimauves	NOM	guimauve
de	PRP	de
la	DET:ART	le
comédie	NOM	comédie
romantique	ADJ	romantique
au	PRP:det	au
genre	NOM	genre
poursuite	NOM	poursuite
en	PRP	en
grosses	ADJ	gros
bagnoles	NOM	bagnole
à	PRP	à
la	DET:ART	le
quot	NOM	quot
Fast	NAM	Fast
and	VER:futu	and
Furious	NOM	Furious
quot	NOM	quot
Résultat	NAM	Résultat
le	DET:ART	le
film	NOM	film
ne	ADV	ne
trouve	VER:pres	trouver
jamais	ADV	jamais
sa	DET:POS	son
vitesse	NOM	vitesse
de	PRP	de
pointe	NOM	pointe
inutilement	ADV	inutilement
ralenti	VER:pper	ralentir
par	PRP	par
une	DET:ART	un
troisième	NUM	troisième
intrigue	NOM	intrigue
gay	ADJ	gay
friendly	NOM	friendly
sympathique	ADJ	sympathique
mais	KON	mais
inutile	ADJ	inutile
,	PUN	,
N	VER:pper	N
