Malgré	PRP	malgré
une	DET:ART	un
introduction	NOM	introduction
prometteuse	ADJ	prometteur
le	DET:ART	le
reste	NOM	reste
est	VER:pres	être
très	ADV	très
convenu	VER:pper	convenir
souvent	ADV	souvent
répétitif	ADJ	répétitif
d'une	NOM	d'une
lourdeur	NOM	lourdeur
parfois	ADV	parfois
même	ADV	même
pénible	ADJ	pénible
Nettement	NOM	Nettement
moins	ADV	moins
réussi	VER:pper	réussir
par	PRP	par
exemple	NOM	exemple
que	KON	que
quot	NOM	quot
Raiponce	NOM	raiponce
quot	ADJ	quot
film	NOM	film
estampillé	VER:pper	estampiller
Disney	NAM	Disney
mais	KON	mais
génétiquement	ADV	génétiquement
modifié	VER:pper	modifier
par	PRP	par
des	PRP:det	du
injections	NOM	injection
d'ADN	ADJ	d'ADN
Pixar	NAM	Pixar
,	PUN	,
N	VER:pper	N
