Sous	PRP	sous
prétexte	ADJ	prétexte
qu'il	NOM	qu'il
est	VER:pres	être
le	DET:ART	le
nouveau	ADJ	nouveau
prodige	NOM	prodige
de	PRP	de
l'animation	NOM	l'animation
japonaise	ADJ	japonais
Mamoru	NAM	Mamoru
Hosoda	NAM	Hosoda
La	DET:ART	le
Traversée	NAM	Traversée
du	PRP:det	du
temps	NOM	temps
Summer	NAM	Summer
Wars	NAM	Wars
a	VER:pres	avoir
été	VER:pper	être
comparé	VER:pper	comparer
à	PRP	à
Miyazaki	NOM	Miyazaki
A	PRP	à
tort	NOM	tort
Ce	VER:subi	Ce
n'est	NOM	n'est
qu'avec	ADJ	qu'avec
cette	PRO:DEM	ce
uvre	NOM	uvre
de	PRP	de
maturité	NOM	maturité
qu'appara	VER:simp	qu'appara
t	VER:pper	t
une	NUM	un
certaine	PRO:IND	certain
filiation	NOM	filiation
pour	KON	pour
lui	PRO:PER	lui
aussi	ADV	aussi
la	DET:ART	le
nature	NOM	nature
est	VER:pres	être
à	PRP	à
la	DET:ART	le
fois	NOM	foi|fois
une	DET:ART	un
source	NOM	source
d'équilibre	ADJ	d'équilibre
pour	PRP	pour
l'homme	NOM	l'homme
et	KON	et
un	NOM	un
rappel	NOM	rappel
de	PRP	de
sa	DET:POS	son
sauvagerie	NOM	sauvagerie
originelle	ADJ	originel
Chacun	NAM	Chacun
retrouvera	VER:futu	retrouver
une	DET:ART	un
sensation	NOM	sensation
sucrée	VER:pper	sucrer
ou	KON	ou
amère	ADJ	amer
de	PRP	de
son	DET:POS	son
enfance	NOM	enfance
dans	PRP	dans
cette	PRO:DEM	ce
chronique	NOM	chronique
familiale	ADJ	familial
d'une	VER:subp	d'une
infinie	ADJ	infini
délicatesse	NOM	délicatesse
,	PUN	,
P	NAM	P
