Une	DET:ART	un
nouvelle	ADJ	nouveau
production	NOM	production
Disney	NAM	Disney
particulièrement	ADV	particulièrement
réussie	VER:pper	réussir
l'histoire	ADJ	l'histoire
d'une	NOM	d'une
princesse	NOM	princesse
que	KON	que
l'on	NOM	l'on
veut	VER:pres	vouloir
marier	VER:infi	marier
à	PRP	à
un	DET:ART	un
prince	NOM	prince
pas	ADV	pas
si	ADV	si
charmant	ADJ	charmant
que	KON	que
a	VER:pres	avoir
et	KON	et
qui	PRO:REL	qui
méprise	VER:pres	mépriser
la	DET:ART	le
gent	NOM	gent
masculine	ADJ	masculin
Un	VER:simp	Un
hymne	NOM	hymne
rigolo	ADJ	rigolo
à	PRP	à
la	DET:ART	le
liberté	NOM	liberté
d'une	NOM	d'une
femme	NOM	femme
,	PUN	,
P	NAM	P
