En	PRP	en
deux	NUM	deux
films	NOM	film
quot	ADJ	quot
La	DET:ART	le
Traversée	NAM	Traversée
du	PRP:det	du
temps	NOM	temps
quot	ADJ	quot
quot	NOM	quot
Summer	NAM	Summer
Wars	NAM	Wars
quot	NOM	quot
Mamoru	NAM	Mamoru
Hosoda	NAM	Hosoda
s'est	VER:futu	s'est
imposé	VER:pper	imposer
comme	ADV	comme
l'un	ADJ	l'un
des	PRP:det	du
grands	ADJ	grand
espoirs	NOM	espoir
de	PRP	de
l'animation	NOM	l'animation
japonaise	ADJ	japonais
quot	NOM	quot
Les	DET:ART	le
Enfants	ADJ	Enfants
loups	NOM	loup
quot	ADJ	quot
portrait	VER:pper	portraire
de	PRP	de
mère	NOM	mère
sacrifiée	VER:pper	sacrifier
n'échappe	NOM	n'échappe
hélas	VER:simp	héler
pas	ADV	pas
toujours	ADV	toujours
à	PRP	à
la	DET:ART	le
lourdeur	NOM	lourdeur
du	PRP:det	du
pathos	NOM	pathos
,	PUN	,
N	VER:pper	N
