Do	NOM	do
vient	VER:pres	venir
que	KON	que
la	DET:ART	le
magie	NOM	magie
n'opère	NOM	n'opère
plus	ADV	plus
Nicolas	NAM	Nicolas
Scholler	NAM	Scholler
n'y	NOM	n'y
met	VER:pres	mettre
pas	ADV	pas
du	PRP:det	du
sien	PRO:POS	sien
avec	PRP	avec
une	DET:ART	un
mise	NOM	mise
en	PRP	en
scène	NOM	scène
inexistante	ADJ	inexistant
Mais	VER:impf	Mais
surtout	ADV	surtout
alors	ADV	alors
que	KON	que
la	DET:ART	le
situation	NOM	situation
est	VER:pres	être
cruelle	ADJ	cruel
le	DET:ART	le
film	NOM	film
est	VER:pres	être
gnangnan	ADJ	gnangnan
Tout	NAM	Tout
est	VER:pres	être
gentiment	ADV	gentiment
policé	VER:pper	policer
sympa	ADJ	sympa
mollasson	NOM	mollasson
La	DET:ART	le
galaxie	NOM	galaxie
Apatow	NAM	Apatow
est	VER:pres	être
entrain	NOM	entrain
de	PRP	de
s'auto	NOM	s'auto
asphyxier	VER:infi	asphyxier
,	PUN	,
N	VER:pper	N
